10.ox
..o.o...o.
.oo.......
o.........
..........
.........o
...oo.oo..
..........
..........
o.........
oo..o.....
